1000000000
0000000000
0200022000
0200000000
2222000000
0000000000
0000222222
0000000000
0000000000
0000022225