m001000100
0001000001
0100011000
0100000011
1111000000
0000000100
1100111111
1000010000
0011000111
101001000e