10111m0000111010010010111
1101101100010100100110001
0101000000110111001101001
0010100001010100110101010
1101001001101010100000110
1100110011011001000001101
1100010101101011000011000
1100101100100100011101010
11000000110011110000110
1011100001110111101101000
0111001101011011101100010
1100100110011110001110100
1010100101010010101001111
0110001100011011010000101
0010101001110100110111000
0000001001010101111000100
1000001110110110110111000
1110000001110100011100111
0111111001111001110100010
0101110011101000000110110
0010010111111000010111111
1010000011111101111011110
0101000000001111111011000
1000110011100100000011110
101011011010100010100e110
