m000000000
0000000000
0100011000
0100000000
1111000000
0000000000
0000111111
0000000000
0000000000
000001111e